TILEMAP
20
15
64
64
00000000000000000000
00011111111000000000
00000000000010000000
00000222220010000000
00100200111111000000
00000200002000000000
00100000002200000000
00000000000000000000
01111000010000000000
01000100010000000000
01110000220000000000
00002111221100000000
00000200000100002200
00000000000000211110
00000000000001200000